2,2,2,2,2,2,2,2,2,2,2,2,2,2,2,2,2,2,2,2,2,2,2,2,2
2,2,2,2,2,2,2,2,2,2,2,2,2,2,2,2,2,2,2,2,2,2,2,2,2
2,2,2,2,2,2,2,2,2,2,2,2,2,2,2,2,2,2,2,2,2,2,2,2,2
2,2,2,2,2,2,2,2,2,2,2,2,2,2,2,2,2,2,2,2,2,2,2,2,2
2,2,2,2,2,2,2,2,2,2,2,2,2,2,2,2,2,2,2,2,2,2,2,2,2
7,7,7,7,7,7,7,7,7,7,7,7,7,7,7,7,7,7,7,7,7,7,7,7,7
10,10,10,10,10,10,10,10,10,10,10,10,10,10,10,10,10,10,10,10,10,10,10,10,10
3,3,3,3,3,3,3,3,3,3,3,3,3,3,3,3,3,4,10,22,3,3,3,3,3
2,2,2,2,2,2,2,2,2,2,2,2,2,2,2,2,2,5,10,9,2,2,2,2,2
2,2,2,2,2,2,2,2,2,2,2,2,2,2,2,2,2,5,10,9,2,2,2,2,2
2,2,2,2,2,2,2,17,11,11,12,2,2,2,2,2,2,5,10,9,2,2,2,2,2
2,2,2,2,2,2,17,21,23,23,18,11,12,2,2,2,2,5,10,9,2,2,2,2,2
2,2,2,2,2,2,24,23,23,23,23,23,13,2,2,2,2,5,10,9,2,2,2,2,2
2,2,2,2,2,2,24,23,23,23,19,15,14,2,2,2,2,5,10,9,2,2,2,2,2
2,2,2,2,2,2,16,20,19,15,14,2,2,2,2,2,2,5,10,9,2,2,2,2,2
2,2,2,2,2,2,2,24,13,2,2,2,2,2,2,2,2,5,10,9,2,2,2,2,2
2,2,2,2,2,2,2,16,14,2,2,2,2,2,2,2,2,5,10,9,2,2,2,2,2
2,2,2,2,2,2,2,2,2,2,2,2,2,2,2,2,2,5,10,9,2,2,2,2,2
2,2,2,2,2,2,2,2,2,2,2,2,2,2,2,2,2,5,10,9,2,2,2,2,2
2,2,2,2,2,2,2,2,2,2,2,2,2,2,2,2,2,5,10,9,2,2,2,2,2